111111111111111111111111111111111111111
133333333000000000000000000000000000001
133333333000000000000000000000000000001
133333333000000011111111111100000000001
133333333000011110000000000000000000001
100000000000110000000000000000000000001
111111111111000000000000000000000000001
100000000001000000000110000000000000001
110000000001100000000001000000000000001
101000000001010000000000100000000000001
100100000001001000000000010000000000001
100010000001000100000000001000000000001
100001000001000010000000000100000000001
100000100001000001000000000010000000001
100000010001000000100000000001000000001
100000000001000000010000000000100000001
100000000001000000001000000000010000001
100000000000000000000100000000001000001
100000000000000100000011100000000100001
100000000000001000000000000000000010001
120000000000010000000000000000000001001
111111111111111111111111111111111111111
