11111
10001
10101
12131
11111
