11111
10301
10101
12131
11111
